°C	ಡಿಗ್ರಿ ಸೆಲ್ಸಿಯಸ್
°F	ಡಿಗ್ರಿ ಫಾರೆನ್ಹೀಟ್
K	ಕೆಲ್ವಿನ್
g	ಗ್ರಾಂ
kg	ಕಿಲೋಗ್ರಾಂ
mg	ಮಿಲಿಗ್ರಾಂ
cm	ಸೆಂಟಿಮೀಟರ್
mm	ಮಿಲಿಮೀಟರ್
km	ಕಿಲೋಮೀಟರ್
m	ಮೀಟರ್
m²	ವರ್ಗ ಮೀಟರ್
cm²	ವರ್ಗ ಸೆಂಟಿಮೀಟರ್
km²	ವರ್ಗ ಕಿಲೋಮೀಟರ್
m³	ಘನ ಮೀಟರ್
cm³	ಘನ ಸೆಂಟಿಮೀಟರ್
km³	ಘನ ಕಿಲೋಮೀಟರ್
l	ಲೀಟರ್
ml	ಮಿಲಿಲೀಟರ್
kl	ಕಿಲೋಲೀಟರ್
Hz	ಹರ್ಟ್ಜ್
kHz	ಕಿಲೋಹರ್ಟ್ಜ್
MHz	ಮೆಗಾಹರ್ಟ್ಜ್
GHz	ಗಿಗಾಹರ್ಟ್ಜ್
W	ವ್ಯಾಟ್
kW	ಕಿಲೋವ್ಯಾಟ್
MW	ಮೆಗಾವ್ಯಾಟ್
V	ವೋಲ್ಟ್
A	ಆಂಪಿಯರ್
Ω	ಓಮ್
Pa	ಪಾಸ್ಕಲ್
kPa	ಕಿಲೋಪಾಸ್ಕಲ್
MPa	ಮೆಗಾಪಾಸ್ಕಲ್
J	ಜೂಲ್
kJ	ಕಿಲೋಜೂಲ್
MJ	ಮೆಗಾಜೂಲ್
N	ನ್ಯೂಟನ್
kN	ಕಿಲೋನ್ಯೂಟನ್

